2 2
16 8
;;
################
###..........###
##..............
###....P........
####...#....####
#######...######
########..######
########..######
::
################
###..........###
##............##
.............###
............####
#######...######
######...#######
######..########
::
########..######
###..........###
##............##
###..........###
####........####
#######.........
###########....#
################
::
######..########
###..........###
##............##
###..........###
####........####
..........######
#....###########
################