3 3
16 8
;;
########...#####
........$.......
................
..........$.....
................
..P........$....
#####...########
######...#######
::
########...#####
........$.......
................
..........$.....
................
...........$....
#####...########
######...#######
::
########...#####
........$.......
................
..........$.....
................
...........$....
#####...########
######...#######
::
########...#####
........$.......
................
..........$.....
................
...........$....
#####...########
######...#######
::
########...#####
........$.......
................
..........$.....
................
...........$....
#####...########
######...#######
::
########...#####
........$.......
................
..........$.....
................
...........$....
#####...########
######...#######
::
########...#####
........$.......
................
..........$.....
................
...........$....
#####...########
######...#######
::
########...#####
........$.......
................
..........$.....
................
...........$....
#####...########
######...#######
